
NO          ./path_to_the_north_texture


SO    ./path_to_the_south_texture

WE ./path_to_the_west_texture


EA   ./path_to_the_east_texture

F 100,100,100
C 110,110,110


1111111   1111111
1000001   1000001
1000001111100000111111111111111111
1000000000000000000000000000000001
100N000000000000000000000100000001
1000000000000000000000000000000001
1111111110111111111111111111111111
        10000000000000001
        11111111111111111
