
NO          ./textures/pixil-frame-0.png


SO    ./textures/pixil-frame-0.png

WE  ./textures/pixil-frame-0.png


EA   ./textures/fun_wall.png


F 100,100,100
C 150,150,150


1111111   1111111
1000001   1000001
1000001111100000111111111111111111
1000000000000000000000000000000001
100N100000000000000000000100000001
1000000000000000000000000000000001
1111111110111111111111111111111111
        10000000000000001
        11111111111111111
