
NO          ./path_to_the_north_texture


SO    ./path_to_the_south_texture

WE ./path_to_the_west_texture


EA   ./path_to_the_east_texture

F 220,100,0
C 123,82,125


1111111
1000001
10000011111
10000000001
1000000000111111111111111111111111111111111111111111111111111111111111111111111111111111111111111111111111111111111111111111111111111111111111111111111111111111111
10000000001
11111111111
       1
